NO images/north.png
SO images/south.png
WE images/west.png
EA images/east.png     

F 164,169,0
C 153,204,243

1111111111111111111111
101000001001100000000111
1010101010111111100000001
100010100010000010001111
111110101111101011101
100000101000101000001
101111101011101111111
101000001010100000101
101011111010111110101
101010001010100010101
101110101010101010101
100000101010001010001
111111101011111011101
100000101000100010001
101110101110101110111
101000100000100010101
101011111111111010101
100010000000000010001
101010111010111111101
1N100000101 100000001
11111111111 111111111

