NO images/north.png
SO images/south.png
WE images/west.png
EA images/east.png     

F 164,169,0
C 153,204,243

11111111111111111111111111
10000000000000000000000001
10001111111111111111111111
101001                  1111
10011    111111111111111  11
1111    1111111110100011  1
10001    1000101000001  111
10101    1011111111111  111
1011   11101     10101111
1011    1111111110101  111
1011    1111111110101  111
10111           10101  111
10001        1110111111111
10001111111 11101110111111
10000000101 100010001  111
10000000011 101110111  111
10100010001 100010101  111
10101111111 11111010111111
10001           1001  1111
101011111111111111101  111
1N100000101 1000000011  11
11111111111 11111111111111

